7
5
1
1
#######
##.$0.#
#..#.##
#..X.##
#######

