7
6
2
2
#######
#..#.##
#.0$0.#
#.$.#.#
#..X.##
#######
